"","Index.Number","Tool","overall","count","count_adverse","count_without_adverse"
"1","Amnesty, Asylum, or Exile.2023.5","Prosecutions_tool","Decreases mass atrocities or CROs ",30,0,30
"2","External Support NSAGs.2023.4","Development assistance_tool","Increases mass atrocities or CROs",18,4,14
"3","Peace Operations.2023.1","Peace operations_tool","No or mixed effects",50,1,49
"4","Peace Operations.2023.12","Peace operations_tool","Decreases mass atrocities or CROs ",43,0,43
"5","Diplomatic Sanctions.2023.2","Comprehensive economic sanctions_tool","No or mixed effects",12,2,10
"6","Mediation.2023.34","Mediation_tool","No or mixed effects",33,0,33
"7","Foreign Assistance.2023.5","Security assistance_tool","No or mixed effects",9,1,8
"8","Amnesty, Asylum, or Exile.2023.14","Peace operations_tool","No or mixed effects",50,1,49
"9","Mediation.2023.19","Mediation_tool","Decreases mass atrocities or CROs ",22,0,22
"10","Mediation.2023.19","Naming_and_shaming_tool","No or mixed effects",13,0,13
"11","Mediation.2023.19","Comprehensive economic sanctions_tool","No or mixed effects",12,2,10
"12","Mediation.2023.19","Peace operations_tool","No or mixed effects",50,1,49
"13","Amnesty, Asylum, or Exile.2023.12","Development assistance_tool","Decreases mass atrocities or CROs ",11,0,11
"14","Mediation.2023.14","Mediation_tool","No or mixed effects",33,0,33
"15","Peace Operations.2023.32","Peace operations_tool","No or mixed effects",50,1,49
"16","Mediation.2023.22","Mediation_tool","No or mixed effects",33,0,33
"17","Peace Operations.2023.30","Peace operations_tool","Decreases mass atrocities or CROs ",43,0,43
"18","Peace Operations.2023.19","Peace operations_tool","No or mixed effects",50,1,49
"19","Foreign Assistance.2023.3","Development assistance_tool","Decreases mass atrocities or CROs ",11,0,11
"20","Peace Operations.2023.45","Peace operations_tool","No or mixed effects",50,1,49
"21","Foreign Assistance.2023.8","Peace operations_tool","Decreases mass atrocities or CROs ",43,0,43
"22","Foreign Assistance.2023.14","Development assistance_tool","No or mixed effects",15,0,15
"23","Peace Operations.2023.26","Targeted sanctions_tool","No or mixed effects",12,0,12
"24","Peace Operations.2023.26","Mediation_tool","No or mixed effects",33,0,33
"25","Peace Operations.2023.21","Peace operations_tool","No or mixed effects",50,1,49
"26","Comprehensive Economic Sanctions.2023.2","Comprehensive economic sanctions_tool","Increases mass atrocities or CROs",19,10,9
"27","Peace Operations.2023.17","Peace operations_tool","No or mixed effects",50,1,49
"28","Comprehensive Economic Sanctions.2023.7","Comprehensive economic sanctions_tool","Increases mass atrocities or CROs",19,10,9
"29","Arms Embargoes.2023.5","Mediation_tool","Decreases mass atrocities or CROs ",22,0,22
"30","Comprehensive Economic Sanctions.2023.6","Targeted sanctions_tool","Increases mass atrocities or CROs",6,5,1
"31","Foreign Assistance.2023.12","Support to non-state armed groups_tool","No or mixed effects",8,0,8
"32","Foreign Assistance.2023.12","Security assistance_tool","Decreases mass atrocities or CROs ",4,0,4
"33","Mediation.2023.33","Mediation_tool","No or mixed effects",33,0,33
"34","Mediation.2023.13","Mediation_tool","No or mixed effects",33,0,33
"35","Amnesty, Asylum, or Exile.2023.2","Prosecutions_tool","No or mixed effects",31,0,31
"36","Amnesty, Asylum, or Exile.2023.2","Amnesties_tool","Increases mass atrocities or CROs",6,3,3
"37","Peace Operations.2023.8","Peace operations_tool","Decreases mass atrocities or CROs ",43,0,43
"38","Peace Operations.2023.8","Peace operations_tool","Increases mass atrocities or CROs",11,4,7
"39","Peace Operations.2023.20","Development assistance_tool","Decreases mass atrocities or CROs ",11,0,11
"40","Peace Operations.2023.20","Security assistance_tool","Decreases mass atrocities or CROs ",4,0,4
"41","Peace Operations.2023.20","Peace operations_tool","No or mixed effects",50,1,49
"42","Targeted Sanctions.2023.4","Development assistance_tool","Increases mass atrocities or CROs",18,4,14
"43","Targeted Sanctions.2023.4","Targeted sanctions_tool","No or mixed effects",12,0,12
"44","Targeted Sanctions.2023.4","Arms embargoes_tool","Decreases mass atrocities or CROs ",4,0,4
"45","Mediation.2023.2","Mediation_tool","No or mixed effects",33,0,33
"46","Amnesty, Asylum, or Exile.2023.15","Mediation_tool","Decreases mass atrocities or CROs ",22,0,22
"47","Naming and Shaming.2023.4","Naming_and_shaming_tool","No or mixed effects",13,0,13
"48","Mediation.2023.9","Mediation_tool","Decreases mass atrocities or CROs ",22,0,22
"49","Mediation.2023.9","Targeted sanctions_tool","Decreases mass atrocities or CROs ",4,0,4
"50","Mediation.2023.9","Arms embargoes_tool","Decreases mass atrocities or CROs ",4,0,4
"51","External Support NSAGs.2023.1","Development assistance_tool","No or mixed effects",15,0,15
"52","Foreign Assistance.2023.11","Development assistance_tool","Decreases mass atrocities or CROs ",11,0,11
"53","Mediation.2023.27","Mediation_tool","No or mixed effects",33,0,33
"54","Amnesty, Asylum, or Exile.2023.10","Mediation_tool","Decreases mass atrocities or CROs ",22,0,22
"55","Peace Operations.2023.40","Mediation_tool","Decreases mass atrocities or CROs ",22,0,22
"56","Peace Operations.2023.40","Peace operations_tool","No or mixed effects",50,1,49
"57","Prosecutions.2023.2","Prosecutions_tool","No or mixed effects",31,0,31
"58","Mediation.2023.25","Mediation_tool","No or mixed effects",33,0,33
"59","Peace Operations.2023.3","Peace operations_tool","Increases mass atrocities or CROs",11,4,7
"60","Peace Operations.2023.28","Peace operations_tool","No or mixed effects",50,1,49
"61","Arms Embargoes.2023.7","Peace operations_tool","Increases mass atrocities or CROs",11,4,7
"62","Arms Embargoes.2023.7","Targeted sanctions_tool","No or mixed effects",12,0,12
"63","Arms Embargoes.2023.7","Peace operations_tool","No or mixed effects",50,1,49
"64","Peace Operations.2023.5","Peace operations_tool","Decreases mass atrocities or CROs ",43,0,43
"65","Mediation.2023.4","Mediation_tool","No or mixed effects",33,0,33
"66","Naming and Shaming.2023.6","Naming_and_shaming_tool","No or mixed effects",13,0,13
"67","Mediation.2023.7","Mediation_tool","Decreases mass atrocities or CROs ",22,0,22
"68","Comprehensive Economic Sanctions.2023.5","Comprehensive economic sanctions_tool","No or mixed effects",12,2,10
"69","Mediation.2023.12","Peace operations_tool","Decreases mass atrocities or CROs ",43,0,43
"70","Mediation.2023.12","Mediation_tool","Decreases mass atrocities or CROs ",22,0,22
"71","Comprehensive Economic Sanctions.2023.1","Targeted sanctions_tool","Increases mass atrocities or CROs",6,5,1
"72","Comprehensive Economic Sanctions.2023.1","Comprehensive economic sanctions_tool","Increases mass atrocities or CROs",19,10,9
"73","Arms Embargoes.2023.6","Prosecutions_tool","Increases mass atrocities or CROs",8,2,6
"74","Arms Embargoes.2023.6","Targeted sanctions_tool","No or mixed effects",12,0,12
"75","Amnesty, Asylum, or Exile.2023.9","Peace operations_tool","Decreases mass atrocities or CROs ",43,0,43
"76","Foreign Assistance.14","Development assistance_tool","Decreases mass atrocities or CROs ",11,0,11
"77","Mediation.02","Mediation_tool","No or mixed effects",33,0,33
"78","Prosecutions.65","Prosecutions_tool","No or mixed effects",31,0,31
"79","Prosecutions.84","Prosecutions_tool","No or mixed effects",31,0,31
"80","Prosecutions.84","Prosecutions_tool","Decreases mass atrocities or CROs ",30,0,30
"81","Mediation.50","Mediation_tool","No or mixed effects",33,0,33
"82","Targeted Sanctions.21","Targeted sanctions_tool","Decreases mass atrocities or CROs ",4,0,4
"83","Prosecutions.10","Prosecutions_tool","Decreases mass atrocities or CROs ",30,0,30
"84","Amnesty, Exile, or Asylum.17","Amnesties_tool","Decreases mass atrocities or CROs ",17,0,17
"85","Amnesty, Exile, or Asylum.17","Amnesties_tool","Increases mass atrocities or CROs",6,3,3
"86","Targeted Sanctions.23","Targeted sanctions_tool","No or mixed effects",12,0,12
"87","Amnesty, Exile, or Asylum.05","Amnesties_tool","Decreases mass atrocities or CROs ",17,0,17
"88","Naming and Shaming.12","Naming_and_shaming_tool","No or mixed effects",13,0,13
"89","Security Assistance.03","Security assistance_tool","Increases mass atrocities or CROs",14,1,13
"90","Security Assistance.03","Security assistance_tool","No or mixed effects",9,1,8
"91","Diplomatic Sanctions.11","Diplomatic sanctions_tool","Increases mass atrocities or CROs",1,0,1
"92","External Support NSAGs.07","Support to non-state armed groups_tool","No or mixed effects",8,0,8
"93","Peace Ops.025","Peace operations_tool","Decreases mass atrocities or CROs ",43,0,43
"94","Mediation.27","Mediation_tool","Increases mass atrocities or CROs",4,0,4
"95","Naming and Shaming.08","Naming_and_shaming_tool","No or mixed effects",13,0,13
"96","Foreign Assistance.01","Development assistance_tool","No or mixed effects",15,0,15
"97","Security Assistance.18","Security assistance_tool","Increases mass atrocities or CROs",14,1,13
"98","Mediation.28","Mediation_tool","No or mixed effects",33,0,33
"99","Arms Embargoes.08","Arms embargoes_tool","No or mixed effects",9,0,9
"100","Arms Embargoes.08","Arms embargoes_tool","Increases mass atrocities or CROs",3,2,1
"101","Prosecutions.06","Prosecutions_tool","Decreases mass atrocities or CROs ",30,0,30
"102","Mediation.15","Mediation_tool","No or mixed effects",33,0,33
"103","Prosecutions.41","Prosecutions_tool","Decreases mass atrocities or CROs ",30,0,30
"104","Targeted Sanctions.01","Targeted sanctions_tool","No or mixed effects",12,0,12
"105","Foreign Assistance.17","Development assistance_tool","Decreases mass atrocities or CROs ",11,0,11
"106","Prosecutions.89","Prosecutions_tool","Decreases mass atrocities or CROs ",30,0,30
"107","Prosecutions.77","Prosecutions_tool","Decreases mass atrocities or CROs ",30,0,30
"108","Peace Ops.076","Peace operations_tool","No or mixed effects",50,1,49
"109","Comprehensive Economic Sanctions.11","Comprehensive economic sanctions_tool","Decreases mass atrocities or CROs ",3,0,3
"110","Peace Ops.043","Peace operations_tool","Decreases mass atrocities or CROs ",43,0,43
"111","Mediation.30","Mediation_tool","No or mixed effects",33,0,33
"112","Mediation.10","Mediation_tool","No or mixed effects",33,0,33
"113","Foreign Assistance.46","Development assistance_tool","Increases mass atrocities or CROs",18,4,14
"114","Arms Embargoes.11","Arms embargoes_tool","No or mixed effects",9,0,9
"115","Prosecutions.73","Prosecutions_tool","No or mixed effects",31,0,31
"116","Prosecutions.07","Prosecutions_tool","No or mixed effects",31,0,31
"117","Comprehensive Economic Sanctions.16","Comprehensive economic sanctions_tool","No or mixed effects",12,2,10
"118","Peace Ops.090","Peace operations_tool","Decreases mass atrocities or CROs ",43,0,43
"119","Prosecutions.03","Prosecutions_tool","No or mixed effects",31,0,31
"120","Foreign Assistance.72","Development assistance_tool","Increases mass atrocities or CROs",18,4,14
"121","Comprehensive Economic Sanctions.37","Comprehensive economic sanctions_tool","No or mixed effects",12,2,10
"122","Arms Embargoes.49","Arms embargoes_tool","Increases mass atrocities or CROs",3,2,1
"123","Comprehensive Economic Sanctions.09","Comprehensive economic sanctions_tool","Increases mass atrocities or CROs",19,10,9
"124","Peace Ops.033","Peace operations_tool","Decreases mass atrocities or CROs ",43,0,43
"125","Prosecutions.01","Prosecutions_tool","Decreases mass atrocities or CROs ",30,0,30
"126","Peace Ops.100","Peace operations_tool","No or mixed effects",50,1,49
"127","Prosecutions.80","Prosecutions_tool","No or mixed effects",31,0,31
"128","Prosecutions.79","Prosecutions_tool","No or mixed effects",31,0,31
"129","Amnesty, Exile, or Asylum.20","Amnesties_tool","Decreases mass atrocities or CROs ",17,0,17
"130","Security Assistance.12","Security assistance_tool","Increases mass atrocities or CROs",14,1,13
"131","Foreign Assistance.44","Development assistance_tool","No or mixed effects",15,0,15
"132","Foreign Assistance.13","Development assistance_tool","Increases mass atrocities or CROs",18,4,14
"133","Foreign Assistance.48","Development assistance_tool","No or mixed effects",15,0,15
"134","Naming and Shaming.03","Naming_and_shaming_tool","No or mixed effects",13,0,13
"135","Peace Ops.056","Peace operations_tool","Decreases mass atrocities or CROs ",43,0,43
"136","Prosecutions.44","Prosecutions_tool","Decreases mass atrocities or CROs ",30,0,30
"137","Peace Ops.083","Peace operations_tool","Decreases mass atrocities or CROs ",43,0,43
"138","Prosecutions.37","Prosecutions_tool","No or mixed effects",31,0,31
"139","Peace Ops.006","Peace operations_tool","No or mixed effects",50,1,49
"140","Foreign Assistance.62","Development assistance_tool","No or mixed effects",15,0,15
"141","Foreign Assistance.62","Development assistance_tool","Increases mass atrocities or CROs",18,4,14
"142","Amnesty, Exile, or Asylum.13","Amnesties_tool","No or mixed effects",6,0,6
"143","Peace Ops.013","Peace operations_tool","No or mixed effects",50,1,49
"144","Amnesty, Exile, or Asylum.23","Amnesties_tool","Decreases mass atrocities or CROs ",17,0,17
"145","Peace Ops.026","Peace operations_tool","No or mixed effects",50,1,49
"146","Comprehensive Economic Sanctions.26","Comprehensive economic sanctions_tool","Increases mass atrocities or CROs",19,10,9
"147","Prosecutions.11","Prosecutions_tool","Decreases mass atrocities or CROs ",30,0,30
"148","Peace Ops.115","Peace operations_tool","No or mixed effects",50,1,49
"149","Prosecutions.18","Prosecutions_tool","Decreases mass atrocities or CROs ",30,0,30
"150","Naming and Shaming.02","Naming_and_shaming_tool","Decreases mass atrocities or CROs ",5,0,5
"151","Comprehensive Economic Sanctions.12","Comprehensive economic sanctions_tool","Increases mass atrocities or CROs",19,10,9
"152","Targeted Sanctions.22","Targeted sanctions_tool","No or mixed effects",12,0,12
"153","Naming and Shaming.01","Naming_and_shaming_tool","Decreases mass atrocities or CROs ",5,0,5
"154","Diplomatic Sanctions.08","Diplomatic sanctions_tool","No or mixed effects",3,0,3
"155","Prosecutions.28","Prosecutions_tool","No or mixed effects",31,0,31
"156","Prosecutions.35","Prosecutions_tool","Increases mass atrocities or CROs",8,2,6
"157","Peace Ops.042","Peace operations_tool","No or mixed effects",50,1,49
"158","Peace Ops.085","Peace operations_tool","No or mixed effects",50,1,49
"159","Prosecutions.20","Prosecutions_tool","Decreases mass atrocities or CROs ",30,0,30
"160","Prosecutions.20","Prosecutions_tool","No or mixed effects",31,0,31
"161","Peace Ops.092","Peace operations_tool","Decreases mass atrocities or CROs ",43,0,43
"162","Foreign Assistance.31","Development assistance_tool","Decreases mass atrocities or CROs ",11,0,11
"163","Peace Ops.032","Peace operations_tool","Decreases mass atrocities or CROs ",43,0,43
"164","Peace Ops.053","Peace operations_tool","No or mixed effects",50,1,49
"165","Peace Ops.053","Peace operations_tool","Increases mass atrocities or CROs",11,4,7
"166","External Support NSAGs.28","Support to non-state armed groups_tool","Increases mass atrocities or CROs",6,0,6
"167","External Support NSAGs.28","Support to non-state armed groups_tool","No or mixed effects",8,0,8
"168","Mediation.16","Mediation_tool","Decreases mass atrocities or CROs ",22,0,22
"169","Peace Ops.015","Peace operations_tool","No or mixed effects",50,1,49
"170","Prosecutions.45","Prosecutions_tool","Decreases mass atrocities or CROs ",30,0,30
"171","Targeted Sanctions.24","Targeted sanctions_tool","Increases mass atrocities or CROs",6,5,1
"172","Targeted Sanctions.24","Targeted sanctions_tool","No or mixed effects",12,0,12
"173","Security Assistance.08","Security assistance_tool","No or mixed effects",9,1,8
"174","Arms Embargoes.05","Arms embargoes_tool","No or mixed effects",9,0,9
"175","Mediation.61","Mediation_tool","No or mixed effects",33,0,33
"176","Amnesty, Exile, or Asylum.16","Amnesties_tool","Decreases mass atrocities or CROs ",17,0,17
"177","Foreign Assistance.18","Development assistance_tool","Increases mass atrocities or CROs",18,4,14
"178","Peace Ops.084","Peace operations_tool","No or mixed effects",50,1,49
"179","Mediation.32","Mediation_tool","Decreases mass atrocities or CROs ",22,0,22
"180","Prosecutions.46","Prosecutions_tool","No or mixed effects",31,0,31
"181","Mediation.23","Mediation_tool","Decreases mass atrocities or CROs ",22,0,22
"182","Peace Ops.117","Peace operations_tool","Decreases mass atrocities or CROs ",43,0,43
"183","Amnesty, Exile, or Asylum.10","Amnesties_tool","No or mixed effects",6,0,6
"184","Mediation.68","Mediation_tool","No or mixed effects",33,0,33
"185","Amnesty, Exile, or Asylum.11","Amnesties_tool","Decreases mass atrocities or CROs ",17,0,17
"186","Security Assistance.31","Security assistance_tool","Increases mass atrocities or CROs",14,1,13
"187","Arms Embargoes.06","Arms embargoes_tool","Decreases mass atrocities or CROs ",4,0,4
"188","Targeted Sanctions.16","Targeted sanctions_tool","Decreases mass atrocities or CROs ",4,0,4
"189","Amnesty, Exile, or Asylum.54","Amnesties_tool","Decreases mass atrocities or CROs ",17,0,17
"190","External Support NSAGs.03","Support to non-state armed groups_tool","Increases mass atrocities or CROs",6,0,6
"191","Foreign Assistance.26","Development assistance_tool","No or mixed effects",15,0,15
"192","Peace Ops.088","Peace operations_tool","Increases mass atrocities or CROs",11,4,7
"193","Prosecutions.49","Prosecutions_tool","Decreases mass atrocities or CROs ",30,0,30
"194","Targeted Sanctions.11","Targeted sanctions_tool","No or mixed effects",12,0,12
"195","Targeted Sanctions.11","Targeted sanctions_tool","Decreases mass atrocities or CROs ",4,0,4
"196","Comprehensive Economic Sanctions.63","Comprehensive economic sanctions_tool","Increases mass atrocities or CROs",19,10,9
"197","Comprehensive Economic Sanctions.63","Comprehensive economic sanctions_tool","No or mixed effects",12,2,10
"198","Prosecutions.90","Prosecutions_tool","No or mixed effects",31,0,31
"199","Prosecutions.66","Prosecutions_tool","Decreases mass atrocities or CROs ",30,0,30
"200","Comprehensive Economic Sanctions.34","Comprehensive economic sanctions_tool","Increases mass atrocities or CROs",19,10,9
"201","Prosecutions.75","Prosecutions_tool","Decreases mass atrocities or CROs ",30,0,30
"202","Mediation.41","Mediation_tool","No or mixed effects",33,0,33
"203","Peace Ops.054","Peace operations_tool","No or mixed effects",50,1,49
"204","External Support NSAGs.18","Support to non-state armed groups_tool","No or mixed effects",8,0,8
"205","Security Assistance.33","Security assistance_tool","No or mixed effects",9,1,8
"206","Peace Ops.062","Peace operations_tool","No or mixed effects",50,1,49
"207","Prosecutions.50","Prosecutions_tool","Increases mass atrocities or CROs",8,2,6
"208","Foreign Assistance.05","Development assistance_tool","No or mixed effects",15,0,15
"209","Peace Ops.125","Peace operations_tool","No or mixed effects",50,1,49
"210","Peace Ops.008","Peace operations_tool","Decreases mass atrocities or CROs ",43,0,43
"211","Peace Ops.005","Peace operations_tool","No or mixed effects",50,1,49
"212","Targeted Sanctions.03","Targeted sanctions_tool","No or mixed effects",12,0,12
"213","Amnesty, Exile, or Asylum.09","Amnesties_tool","No or mixed effects",6,0,6
"214","Security Assistance.39","Security assistance_tool","Increases mass atrocities or CROs",14,1,13
"215","Mediation.21","Mediation_tool","No or mixed effects",33,0,33
"216","Foreign Assistance.09","Development assistance_tool","Increases mass atrocities or CROs",18,4,14
"217","Mediation.26","Mediation_tool","No or mixed effects",33,0,33
"218","Security Assistance.13","Security assistance_tool","Increases mass atrocities or CROs",14,1,13
"219","Security Assistance.04","Security assistance_tool","No or mixed effects",9,1,8
"220","Peace Ops.002","Peace operations_tool","Decreases mass atrocities or CROs ",43,0,43
"221","Mediation.34","Mediation_tool","Increases mass atrocities or CROs",4,0,4
"222","Foreign Assistance.12","Development assistance_tool","Decreases mass atrocities or CROs ",11,0,11
"223","Naming and Shaming.09","Naming_and_shaming_tool","Decreases mass atrocities or CROs ",5,0,5
"224","Prosecutions.23","Prosecutions_tool","No or mixed effects",31,0,31
"225","Security Assistance.25","Security assistance_tool","Increases mass atrocities or CROs",14,1,13
"226","Peace Ops.098","Peace operations_tool","Decreases mass atrocities or CROs ",43,0,43
"227","Naming and Shaming.18","Naming_and_shaming_tool","Decreases mass atrocities or CROs ",5,0,5
"228","Peace Ops.012","Peace operations_tool","Decreases mass atrocities or CROs ",43,0,43
"229","Naming and Shaming.07","Naming_and_shaming_tool","No or mixed effects",13,0,13
"230","Prosecutions.04","Prosecutions_tool","Decreases mass atrocities or CROs ",30,0,30
"231","Foreign Assistance.27","Development assistance_tool","Decreases mass atrocities or CROs ",11,0,11
"232","Peace Ops.080","Peace operations_tool","Decreases mass atrocities or CROs ",43,0,43
"233","Security Assistance.02","Security assistance_tool","Decreases mass atrocities or CROs ",4,0,4
"234","Prosecutions.22","Prosecutions_tool","Decreases mass atrocities or CROs ",30,0,30
"235","Foreign Assistance.04","Development assistance_tool","No or mixed effects",15,0,15
"236","Diplomatic Sanctions.06","Diplomatic sanctions_tool","No or mixed effects",3,0,3
"237","Mediation.22","Mediation_tool","Decreases mass atrocities or CROs ",22,0,22
"238","External Support NSAGs.27","Support to non-state armed groups_tool","Increases mass atrocities or CROs",6,0,6
"239","Amnesty, Exile, or Asylum.53","Amnesties_tool","No or mixed effects",6,0,6
"240","Prosecutions.12","Prosecutions_tool","No or mixed effects",31,0,31
"241","Security Assistance.19","Security assistance_tool","No or mixed effects",9,1,8
"242","Naming and Shaming.14","Naming_and_shaming_tool","Increases mass atrocities or CROs",3,0,3
"243","Amnesty, Exile, or Asylum.06","Amnesties_tool","Increases mass atrocities or CROs",6,3,3
"244","Mediation.67","Mediation_tool","No or mixed effects",33,0,33
"245","Mediation.47","Mediation_tool","No or mixed effects",33,0,33
"246","Foreign Assistance.42","Development assistance_tool","No or mixed effects",15,0,15
"247","Comprehensive Economic Sanctions.22","Comprehensive economic sanctions_tool","Decreases mass atrocities or CROs ",3,0,3
"248","Amnesty, Exile, or Asylum.14","Amnesties_tool","Decreases mass atrocities or CROs ",17,0,17
"249","Amnesty, Exile, or Asylum.02","Amnesties_tool","No or mixed effects",6,0,6
"250","Comprehensive Economic Sanctions.75","Comprehensive economic sanctions_tool","No or mixed effects",12,2,10
"251","Arms Embargoes.26","Arms embargoes_tool","No or mixed effects",9,0,9
"252","Prosecutions.21","Prosecutions_tool","No or mixed effects",31,0,31
"253","Peace Ops.049","Peace operations_tool","Increases mass atrocities or CROs",11,4,7
"254","Amnesty, Exile, or Asylum.03","Amnesties_tool","Decreases mass atrocities or CROs ",17,0,17
"255","Peace Ops.097","Peace operations_tool","No or mixed effects",50,1,49
"256","Peace Ops.124","Peace operations_tool","No or mixed effects",50,1,49
"257","External Support NSAGs.11","Support to non-state armed groups_tool","No or mixed effects",8,0,8
"258","Security Assistance.35","Security assistance_tool","Decreases mass atrocities or CROs ",4,0,4
"259","Mediation.01","Mediation_tool","Increases mass atrocities or CROs",4,0,4
"260","Peace Ops.078","Peace operations_tool","Decreases mass atrocities or CROs ",43,0,43
"261","Peace Ops.045","Peace operations_tool","No or mixed effects",50,1,49
"262","Peace Ops.103","Peace operations_tool","No or mixed effects",50,1,49
"263","Prosecutions.76","Prosecutions_tool","No or mixed effects",31,0,31
"264","Prosecutions.76","Prosecutions_tool","Increases mass atrocities or CROs",8,2,6
"265","Mediation.63","Mediation_tool","No or mixed effects",33,0,33
"266","Amnesty, Exile, or Asylum.24","Amnesties_tool","Decreases mass atrocities or CROs ",17,0,17
"267","Prosecutions.15","Prosecutions_tool","No or mixed effects",31,0,31
"268","Naming and Shaming.16","Naming_and_shaming_tool","No or mixed effects",13,0,13
"269","Peace Ops.059","Peace operations_tool","Decreases mass atrocities or CROs ",43,0,43
"270","Peace Ops.107","Peace operations_tool","No or mixed effects",50,1,49
"271","Peace Ops.107","Peace operations_tool","Increases mass atrocities or CROs",11,4,7
"272","Peace Ops.107","Peace operations_tool","Decreases mass atrocities or CROs ",43,0,43
"273","Naming and Shaming.04","Naming_and_shaming_tool","No or mixed effects",13,0,13
"274","Naming and Shaming.20","Naming_and_shaming_tool","Decreases mass atrocities or CROs ",5,0,5
"275","Foreign Assistance.38","Development assistance_tool","Increases mass atrocities or CROs",18,4,14
"276","Arms Embargoes.12","Arms embargoes_tool","No or mixed effects",9,0,9
"277","Peace Ops.116","Peace operations_tool","Decreases mass atrocities or CROs ",43,0,43
"278","Security Assistance.07","Security assistance_tool","No or mixed effects",9,1,8
"279","Foreign Assistance.64","Development assistance_tool","Decreases mass atrocities or CROs ",11,0,11
"280","Arms Embargoes.15","Arms embargoes_tool","No or mixed effects",9,0,9
"281","Peace Ops.022","Peace operations_tool","No or mixed effects",50,1,49
"282","Naming and Shaming.10","Naming_and_shaming_tool","Increases mass atrocities or CROs",3,0,3
"283","Prosecutions.82","Prosecutions_tool","No or mixed effects",31,0,31
"284","Prosecutions.86","Prosecutions_tool","Decreases mass atrocities or CROs ",30,0,30
"285","Comprehensive Economic Sanctions.43","Comprehensive economic sanctions_tool","Decreases mass atrocities or CROs ",3,0,3
"286","Peace Ops.047","Peace operations_tool","Decreases mass atrocities or CROs ",43,0,43
"287","Mediation.09","Mediation_tool","Increases mass atrocities or CROs",4,0,4
"288","Prosecutions.33","Prosecutions_tool","No or mixed effects",31,0,31
"289","Peace Ops.004","Peace operations_tool","No or mixed effects",50,1,49
"290","External Support NSAGs.01","Support to non-state armed groups_tool","No or mixed effects",8,0,8
"291","Comprehensive Economic Sanctions.23","Comprehensive economic sanctions_tool","No or mixed effects",12,2,10
"292","Amnesty, Exile, or Asylum.19","Amnesties_tool","Increases mass atrocities or CROs",6,3,3
"293","Amnesty, Exile, or Asylum.19","Amnesties_tool","Decreases mass atrocities or CROs ",17,0,17
"294","Peace Ops.063","Peace operations_tool","Decreases mass atrocities or CROs ",43,0,43
"295","Prosecutions.63","Prosecutions_tool","Decreases mass atrocities or CROs ",30,0,30
"296","Peace Ops.067","Peace operations_tool","Decreases mass atrocities or CROs ",43,0,43
"297","Security Assistance.34","Security assistance_tool","Increases mass atrocities or CROs",14,1,13
"298","Arms Embargoes.17","Arms embargoes_tool","Decreases mass atrocities or CROs ",4,0,4
"299","Prosecutions.29","Prosecutions_tool","No or mixed effects",31,0,31
"300","Prosecutions.13","Prosecutions_tool","Increases mass atrocities or CROs",8,2,6
"301","Prosecutions.13","Prosecutions_tool","No or mixed effects",31,0,31
"302","Security Assistance.05","Security assistance_tool","Increases mass atrocities or CROs",14,1,13
"303","Mediation.64","Mediation_tool","No or mixed effects",33,0,33
"304","Mediation.03","Mediation_tool","Decreases mass atrocities or CROs ",22,0,22
"305","Prosecutions.67","Prosecutions_tool","No or mixed effects",31,0,31
"306","Diplomatic Sanctions.02","Diplomatic sanctions_tool","No or mixed effects",3,0,3
"307","Foreign Assistance.10","Development assistance_tool","Increases mass atrocities or CROs",18,4,14
"308","Foreign Assistance.57","Development assistance_tool","No or mixed effects",15,0,15
"309","Naming and Shaming.19","Naming_and_shaming_tool","No or mixed effects",13,0,13
"310","Peace Ops.055","Peace operations_tool","Decreases mass atrocities or CROs ",43,0,43
"311","Amnesty, Exile, or Asylum.12","Amnesties_tool","Increases mass atrocities or CROs",6,3,3
"312","Amnesty, Exile, or Asylum.12","Amnesties_tool","Decreases mass atrocities or CROs ",17,0,17
"313","Naming and Shaming.11","Naming_and_shaming_tool","No or mixed effects",13,0,13
"314","Prosecutions.08","Prosecutions_tool","No or mixed effects",31,0,31
"315","External Support NSAGs.04","Support to non-state armed groups_tool","Decreases mass atrocities or CROs ",1,0,1
"316","Peace Ops.020","Peace operations_tool","Decreases mass atrocities or CROs ",43,0,43
"317","Peace Ops.081","Peace operations_tool","Decreases mass atrocities or CROs ",43,0,43
"318","Comprehensive Economic Sanctions.04","Comprehensive economic sanctions_tool","Increases mass atrocities or CROs",19,10,9
"319","Comprehensive Economic Sanctions.91","Comprehensive economic sanctions_tool","Increases mass atrocities or CROs",19,10,9
"320","Peace Ops.111","Peace operations_tool","No or mixed effects",50,1,49
"321","Peace Ops.017","Peace operations_tool","Increases mass atrocities or CROs",11,4,7
"322","Amnesty, Exile, or Asylum.56","Amnesties_tool","Increases mass atrocities or CROs",6,3,3
"323","Foreign Assistance.29","Development assistance_tool","Increases mass atrocities or CROs",18,4,14
"324","Amnesty, Exile, or Asylum.39","Amnesties_tool","Decreases mass atrocities or CROs ",17,0,17
"325","Peace Ops.110","Peace operations_tool","No or mixed effects",50,1,49
"326","Peace Ops.110","Peace operations_tool","Increases mass atrocities or CROs",11,4,7
"327","Mediation.46","Mediation_tool","Decreases mass atrocities or CROs ",22,0,22
"328","Amnesty, Exile, or Asylum.04","Amnesties_tool","Decreases mass atrocities or CROs ",17,0,17
"329","Mediation.06","Mediation_tool","Decreases mass atrocities or CROs ",22,0,22
"330","Security Assistance.01","Security assistance_tool","Increases mass atrocities or CROs",14,1,13
"331","Mediation.56","Mediation_tool","Decreases mass atrocities or CROs ",22,0,22
"332","Peace Ops.108","Peace operations_tool","Decreases mass atrocities or CROs ",43,0,43
"333","Peace Ops.089","Peace operations_tool","Decreases mass atrocities or CROs ",43,0,43
"334","Peace Ops.044","Peace operations_tool","No or mixed effects",50,1,49
"335","Targeted Sanctions.12","Targeted sanctions_tool","Increases mass atrocities or CROs",6,5,1
"336","Naming and Shaming.21","Naming_and_shaming_tool","Increases mass atrocities or CROs",3,0,3
"337","Amnesty, Exile, or Asylum.07","Amnesties_tool","No or mixed effects",6,0,6
"338","Comprehensive Economic Sanctions.53","Comprehensive economic sanctions_tool","No or mixed effects",12,2,10
"339","Peace Ops.060","Peace operations_tool","Decreases mass atrocities or CROs ",43,0,43
"340","Peace Ops.019","Peace operations_tool","Decreases mass atrocities or CROs ",43,0,43
"341","Mediation.44","Mediation_tool","No or mixed effects",33,0,33
"342","Naming and Shaming.06","Naming_and_shaming_tool","No or mixed effects",13,0,13
"343","Foreign Assistance.39","Development assistance_tool","Increases mass atrocities or CROs",18,4,14
"344","Foreign Assistance.28","Development assistance_tool","Increases mass atrocities or CROs",18,4,14
"345","Prosecutions.16","Prosecutions_tool","Decreases mass atrocities or CROs ",30,0,30
"346","Prosecutions.32","Prosecutions_tool","No or mixed effects",31,0,31
"347","External Support NSAGs.05","Support to non-state armed groups_tool","No or mixed effects",8,0,8
"348","Comprehensive Economic Sanctions.29","Comprehensive economic sanctions_tool","Increases mass atrocities or CROs",19,10,9
"349","Peace Ops.101","Peace operations_tool","Increases mass atrocities or CROs",11,4,7
"350","Diplomatic Sanctions.01","Diplomatic sanctions_tool","Decreases mass atrocities or CROs ",1,0,1
"351","Comprehensive Economic Sanctions.71","Comprehensive economic sanctions_tool","Increases mass atrocities or CROs",19,10,9
"352","Arms Embargoes.07","Arms embargoes_tool","No or mixed effects",9,0,9
"353","Foreign Assistance.56","Development assistance_tool","Decreases mass atrocities or CROs ",11,0,11
"354","External Support NSAGs.15","Support to non-state armed groups_tool","Increases mass atrocities or CROs",6,0,6
"355","Prosecutions.30","Prosecutions_tool","Decreases mass atrocities or CROs ",30,0,30
"356","Peace Ops.066","Peace operations_tool","No or mixed effects",50,1,49
"357","Comprehensive Economic Sanctions.81","Comprehensive economic sanctions_tool","No or mixed effects",12,2,10
"358","Prosecutions.17","Prosecutions_tool","No or mixed effects",31,0,31
"359","Comprehensive Economic Sanctions.44","Comprehensive economic sanctions_tool","Increases mass atrocities or CROs",19,10,9
"360","Peace Ops.016","Peace operations_tool","Decreases mass atrocities or CROs ",43,0,43
"361","Peace Ops.027","Peace operations_tool","Decreases mass atrocities or CROs ",43,0,43
"362","Peace Ops.072","Peace operations_tool","Increases mass atrocities or CROs",11,4,7
"363","Peace Ops.114","Peace operations_tool","Decreases mass atrocities or CROs ",43,0,43
"364","Comprehensive Economic Sanctions.92","Comprehensive economic sanctions_tool","No or mixed effects",12,2,10
"365","Peace Ops.091","Peace operations_tool","Decreases mass atrocities or CROs ",43,0,43
"366","Security Assistance.38","Security assistance_tool","No or mixed effects",9,1,8
"367","Comprehensive Economic Sanctions.62","Comprehensive economic sanctions_tool","Increases mass atrocities or CROs",19,10,9
"368","Security Assistance.21","Security assistance_tool","Increases mass atrocities or CROs",14,1,13
"369","Foreign Assistance.45","Development assistance_tool","No or mixed effects",15,0,15
"370","Prosecutions.27","Prosecutions_tool","Decreases mass atrocities or CROs ",30,0,30
"371","Arms Embargoes.14","Arms embargoes_tool","No or mixed effects",9,0,9
"372","Security Assistance.11","Security assistance_tool","Increases mass atrocities or CROs",14,1,13
"373","Comprehensive Economic Sanctions.56","Comprehensive economic sanctions_tool","Increases mass atrocities or CROs",19,10,9
"374","Peace Ops.003","Peace operations_tool","No or mixed effects",50,1,49
"375","Peace Ops.099","Peace operations_tool","Decreases mass atrocities or CROs ",43,0,43
"376","Mediation.37","Mediation_tool","Decreases mass atrocities or CROs ",22,0,22
"377","Prosecutions.61","Prosecutions_tool","No or mixed effects",31,0,31
"378","Prosecutions.61","Prosecutions_tool","Increases mass atrocities or CROs",8,2,6
"379","Mediation.11","Mediation_tool","No or mixed effects",33,0,33
"380","Foreign Assistance.03","Development assistance_tool","No or mixed effects",15,0,15
"381","Foreign Assistance.67","Development assistance_tool","No or mixed effects",15,0,15
"382","Mediation.45","Mediation_tool","No or mixed effects",33,0,33
"383","Peace Ops.093","Peace operations_tool","No or mixed effects",50,1,49
"384","Comprehensive Economic Sanctions.05","Comprehensive economic sanctions_tool","No or mixed effects",12,2,10
"385","Mediation.17","Mediation_tool","Decreases mass atrocities or CROs ",22,0,22
"386","Mediation.35","Mediation_tool","No or mixed effects",33,0,33
"387","Targeted Sanctions.05","Targeted sanctions_tool","No or mixed effects",12,0,12
"388","Peace Ops.007","Peace operations_tool","Decreases mass atrocities or CROs ",43,0,43
"389","Peace Ops.024","Peace operations_tool","No or mixed effects",50,1,49
"390","Mediation.05","Mediation_tool","Decreases mass atrocities or CROs ",22,0,22
"391","External Support NSAGs.06","Support to non-state armed groups_tool","Increases mass atrocities or CROs",6,0,6
"392","Prosecutions.25","Prosecutions_tool","Decreases mass atrocities or CROs ",30,0,30
"393","Foreign Assistance.65","Development assistance_tool","Increases mass atrocities or CROs",18,4,14
"394","Peace Ops.058","Peace operations_tool","No or mixed effects",50,1,49
"395","External Support NSAGs.22","Support to non-state armed groups_tool","No or mixed effects",8,0,8
"396","Foreign Assistance.43","Development assistance_tool","No or mixed effects",15,0,15
"397","Naming and Shaming.13","Naming_and_shaming_tool","No or mixed effects",13,0,13
"398","Mediation.20","Mediation_tool","No or mixed effects",33,0,33
"399","Prosecutions.34","Prosecutions_tool","Decreases mass atrocities or CROs ",30,0,30
"400","Foreign Assistance.47","Development assistance_tool","Increases mass atrocities or CROs",18,4,14
"401","Peace Ops.126","Peace operations_tool","Decreases mass atrocities or CROs ",43,0,43
"402","Comprehensive Economic Sanctions.32","Comprehensive economic sanctions_tool","Increases mass atrocities or CROs",19,10,9
"403","Mediation.52","Mediation_tool","Decreases mass atrocities or CROs ",22,0,22
"404","Peace Ops.010","Peace operations_tool","No or mixed effects",50,1,49
"405","Prosecutions.85","Prosecutions_tool","Decreases mass atrocities or CROs ",30,0,30
"406","Targeted Sanctions.25","Targeted sanctions_tool","Increases mass atrocities or CROs",6,5,1
"407","Prosecutions.38","Prosecutions_tool","Decreases mass atrocities or CROs ",30,0,30
"408","Mediation.14","Mediation_tool","Decreases mass atrocities or CROs ",22,0,22
"409","Arms Embargoes.04","Arms embargoes_tool","Increases mass atrocities or CROs",3,2,1
"410","Arms Embargoes.04","Arms embargoes_tool","No or mixed effects",9,0,9
"411","Targeted Sanctions.08","Targeted sanctions_tool","Increases mass atrocities or CROs",6,5,1
"412","Mediation.18","Mediation_tool","Decreases mass atrocities or CROs ",22,0,22
"413","Mediation.07","Mediation_tool","No or mixed effects",33,0,33
"414","Peace Ops.023","Peace operations_tool","No or mixed effects",50,1,49
"415","External Support NSAGs.19","Support to non-state armed groups_tool","Increases mass atrocities or CROs",6,0,6
"416","Mediation.51","Mediation_tool","No or mixed effects",33,0,33
"417","Prosecutions.31","Prosecutions_tool","Decreases mass atrocities or CROs ",30,0,30
"418","Peace Ops.094","Peace operations_tool","No or mixed effects",50,1,49
"419","Foreign Assistance.37","Development assistance_tool","Increases mass atrocities or CROs",18,4,14
"420","Prosecutions.42","Prosecutions_tool","Increases mass atrocities or CROs",8,2,6
"421","Comprehensive Economic Sanctions.24","Comprehensive economic sanctions_tool","Increases mass atrocities or CROs",19,10,9
"422","Amnesty, Exile, or Asylum.41","Amnesties_tool","Decreases mass atrocities or CROs ",17,0,17
"423","Peace Ops.009","Peace operations_tool","No or mixed effects",50,1,49
"424","Peace Ops.069","Peace operations_tool","No or mixed effects",50,1,49
